11111111111
10C000110E1
100C00C0001
1P00110C001
11111111111