11111111111111
100100000001C1
10000111110011
1P0011E1000001
11111111111111